#S###################
#   #           #   #
### # ### ####### # #
#   #   #     #   # #
# ##### ##### # ### #
#     #     # #   # #
##### ####### ### # #
#   #   #   # #   # #
# ##### # # # # ### #
#     # # # #     # #
# ### # # # # ##### #
# # #   # # # # #   #
# # ##### # # # # ###
# #       # #   #   #
# # ##### # ####### #
# # #     # #       #
# ### ##### # ##### #
#     #     # #   # #
####### ##### # ### #
#             #     #
###################E#
